2 13 31
1-----------------------------2
|p * *      *   B** * *      *|
|w w w w w*w w w*w w w w w w*w|
|    * * *** **      *    **  |
| w*w w w w w w wbw1w w w w w*|
|          *     **      *  **|
| w w*w w w w w w*w*w*w*w w w |
|   *        *   * *x* *      |
| w w w w*w w w w w w w*w w*w |
|   ****         *            |
| w w w w w w w w w*w w w w w*|
|  ** *   *                   |
3-----------------------------4


