2 13 31
1-----------------------------2
|p x *      *   B** * *      *|
|w w w w w*w w w*w w w w w w*w|
|    * * *** **  S   *    **  |
| w*w w w w w w w*www w w w w*|
|          *  B  **      *  **|
| w w*w w w w w w*w*w*w*w w w |
|   *        *   * *x* *      |
| w w w w*w w w w w w w*w w*w |
|   ****         *            |
| w w w w w w w w w*w w w w w*|
|  ** *   *                   |
3-----------------------------4


