3 13 31
1-----------------------------2
|               B             |
| wwwwww***wwwwwwwwwww***wwww |
| wS * * *** ** ~    * S  **w |
| ***     p     *    G   *  * |
| *        *    ~**      *  * |
|Bw~~~~~~***~~~~~~~~~~***~~~wB|
| w *        *  ~ *x* *     w |
| * *  *  G     *    x * S ** |
| * ***    S    ~*      G   * |
| wwwwwww***wwwwwwwwww***wwww |
|               B             |
3-----------------------------4