2 13 31
1-----------------------------2
|p * *j       *  ** * *      *|
|w w w w w*w w w*w w w w w w*w|
|    * * *** **      *    **  |
| w*w w w w wjw wbw1w w w w w*|
|          *     **      *  **|
| w w*w w w w w w*w*w*w*w w w |
|   *        *   * *x* *      |
| w w w w*w w w w w w w*w w*w |
|   ****         *j           |
| w w w w w w w w w*w w w w w*|
|  ** *   *    j              |
3-----------------------------4


