2 13 31
1-----------------------------2
|p x *      *   B** * *   ~  *|
|  ~~~    *     *        ~  * |
|    * * *** **  S   *  ~ **  |
|  *          ~  *     ~     *|
| ~~~      *~~~~~**      *  **|
|    *    ~~~~~~~~~** * *     |
|   *      ~~~~~~~* * *       |
|        *    ~        *   *  |
|   ****         *            |
|   ~~~~           *        ~*|
|  ** *   *        G       ~~ |
3-----------------------------4


