1 13 31
1-----------------------------2
|p    x    *   *   *  * * *   |
|F     *     * *       * * *  |
|  **wwwww***  *  Swwwwwww* * |
|          *   w * *         *|
|*     S   * **w *  *         |
|              w   *   *      |
|*  *      *  *w  S  *        |
|        *     w * *          |
|*    **  *       *           |
|  *             *            |
|    www    *   *  *  www     |
3-----------------------------4
