1 13 31
1-----------------------------2
|p    x    *   *   *  * * *   |
|Fw w w*w w w*w*w w w w*w*w*w |
|  **     ***  *     S    * * |
| w w w w w*w w w*w*w w w w w*|
|*     S   * **  *  *         |
| w w w w w w w w w*w w*w w w |
|*  *      *  *   S  *        |
| w w w w*w w w w*w*w w w w w |
|*    **  *       *           |
| w*w w w w w w w*w w w w w w |
|           *   *  *          |
3-----------------------------4
