20 20
####################
#                  #
#                  #
#                  #
#   p              #
#                  #
#                  #
#                  #
#                  #
#       ###        #
#                  #
#       ###        #
#        #         #
#        #         #
#       ###        #
#                  #
#                  #
#                  #
#                  #
####################